##################
#................#
#.......B...B....#
#...X............#
#.........G......#
#.....O..........#
#................#
##################