########
#......#
#P..B..#
#.....G#
########
---
#######
#.....#
#.P...#
#..B..#
#..G..#
#######
---
#########
#.......#
#.P.....#
#.B.....#
#..B....#
#...G...#
#########